Row ID	行ID
Order ID	订单号
Order Date	订单日期
Ship Date	发货日期
Ship Mode	发货方式
Customer ID	客户ID
Customer Name	客户姓名
Segment	客户类别
Country	国家
City	城市
State	省
Postal Code	邮政编码
Region	区
Product ID	商品ID
Category	商品一级分类
Sub-Category	商品二级分类
Product Name	商品名称
Sales	销售额
Quantity	销售数量
Discount	折扣比例
Profit	利润


